###############
#  E       E  #
# E E E E E E #
# # # # # # # #
# # # # # # # #
# # E #E# # E #
# # #     # # #
#     # #     #
## ##     ## ##
#     # #     #
# # # ### # # #
# E E E E # E #
# E # # # # # #
#   P #P#     #
###############